55555555677855555555
411111119;:<41111111
41110000011114111410
41110000000001441141
41000000000000141410
41000001000000011000
41000011100000000000
41000001000000677800
410000000000039;:<00
41000000000000000000
41000000000000000000
41000000000000000000
41001677780011677800
410019;:;<00119;:<00
41000000000000000000
41000000000000000000
41000000000000000000
41000000000000000000
41111111111111111111
55555555555555555555