55555544444444444444
11111522211111112116
11111522111111122219
11111521111111112111
00000500000000000000
00000500022000000000
11000500022001111100
21000500000001222100
11000300000001242100
00000222200001222100
00000222200001222100
01111222200111222100
02222500000111111100
02222400000000000000
01111400000000000000
00000400000000000000
00000400000014444444
00000400000141312222
00000400000141112222
55555555555444444444
