44444444444444444444
77777800000000000004
:::;:<00000000000004
11100000000000000004
00000000000011677804
000000000000119;:<04
00000000000000000004
00000000000000000004
00000110110000000001
00001221221000000001
00001221221000000004
00000110110000000004
00000000000000000004
00000000000000000004
00000011110000000004
00000012210000000004
44444442211100000004
22222221122100000004
22222221122100000004
44444444444444444444
