44444444444444444444
44444444444444411111
44444444444444222222
44444444444442222222
44444444444424224444
44444444444444444444
44444444444444444444
44444444444444444444
11222244444444444444
11222244444444444444
44441144444444444444
44441144444467784444
4444112222449;:<4444
44441122220000004444
44444444444444444444
44444444444444444444
44444444444444444444
44444444444444444444
44444444444444444444
44444444444444444444